CCCCCCCCCW
WWWCCCWWCW
WCCCCCCWCW
WCWWWWWWCW
WCWCCCCWCW
WCWCTCCWCW
WCWCCCCWCW
WCWWWWCWCW
WCCCCCCCCW
WWWWWWWWWW