CCCCWWCCCC
CCCCWWCCCC
CCCCWWCCCC
CCCCWWCCCC
CCCCCCCCCC
CCCCCCCCCC
CCCCWWCCCC
CCCCWWCWWW
CCCCWWCWTC
CCCCWWCCCC